EEEEEEEEEEEEEEEEEEEEEEEEEEEEEEEEEEEEEEEEEEEEEEEEEE
E                    EEEEEEEEEEEEEEEEE           E
EEEEEEEEEEEEEEEEEEEE EEEEEEEEEEEEEEEEE EEEEEEEEEEE
EEEEEEEE     EEEEEEE EE                EEEEEEEEEEE
EEEE EEE EEEEEEEEEEE EEEEEEEEEEEEEEEEE EEEEEEEEEEE
EEEE EEE                                        EE
EEEE EEEE EEEEEEEEEEEEEEEEEEEEEEEEEEEEEEE EEEEE EE
EEEE EEEE EEEE         EEEEEEEEEE EEEEEEE EEEEE EE
EEEE EEEE EEEE EEEEEEEEEEEEEEEEEE EEEEEEE EEEEE EE
EEEE EEEE EEEE EEEEEEEEEEEEEEEEEE EEEEEEE EEEEE EE
E         EEEE EEEEEEEEEEEEEEEEEE EEEEEEE EEEEE EE
E EEEEEEE EEEE                    EEEEEEE EEEEE EE
E EEEEEEE   EE EEEEEEEEEEEEEEEEEEEEEEEEEE EEEEE EE
E EEEEEEEEE EE EEEEEEEEEEEEEEEEEEEEEEEEEEEEEEEE EE
E EEEEEEE E EE                                  EE
E EEEEEEE E EEEEEEEEEEE EEEEEEEEEEEEEEEEEEEEEEEEEE
E EEEEEEE E EEEEEEEEEEE EEEEEEEEEEEEEEEEEEEEEEEEEE
E EEEEEEE E EEEEEEEEEEE EEEEEEEEEEEEEEEEEEEEEEEEEE
E         E EEEEEEEEEEE                   EEEEEEEE
EEEEEEEEEEE EEEEEEEEEEEEEEEEEEEEEEEEEEEEEEEEEEEEEE
E                                               EE
E EEEEEEEEEEE EEEEEEEEEEEEEEEEEEEEEEEEEEEEEEEEEEEE
E             EEEEEEEEEEEEEEEEEEEEEEEEEEEEEEEEEEEE
EEEEEEEEEEEEE                                   $E
EEEEEEEEEEEEEEEEEEEEEEEEEEEEEEEEEEEEEEEEEEEEEEEEEE