#################################################
#                    #################          #
######### ############################ ##########
######### ############################ ##########
######### ############################ ##########
#########                                       #
######### #######################################
######### #######################################
######### #######################################
######### #######################################
#         #######################################
# ####### #######################################
# ####### #######################################
# ####### #######################################
# ####### #######################################
# ####### #######################################
# ####### #######################################
# ####### #######################################
# ####### #######################################
# ###############################################
#                                      ##########
#################################################
